SO ./textures/southwall.png
NO ./textures/southwall.png
WE ./textures/southwall.png
EA ./textures/southwall.png

C 0,0,255
C 0,255,255
FF 255,0,0

111111
1N0001
100001
100001
111111
