SO ./textures/southwall.png
NO ./textures/adfufghshosgff.png
WE ./textures/southwall.png
EA ./textures/southwall.png

C 255,255,255


F 255,0,0 

111111
1N1
111
