NO ./north.xpm
SO ./south.xpm
WE ./west.xpm
EA ./east.xpm
F 220,100,0
C 225,30,0

1111111111111111111111111
110000000000000000000001
100000000000000000000001
100000000000000000000001
100000111110000101010001
1000000100000000000011
10000011010000100010001
10000011010000000000001
100000100110000001010001
100000000000000000000001
100000000000000000000001
10000000000000000000111
1000000000000000000001
11000000000000111100011
11100000000000000000011
111100000000000000000001
10000100000000000000111
100000111100000000000011
110100011000000000000001
110111111100000000000N01
1011111110000100100001001
11111111111111111111111111
