NO ./north.xpm
SO ./south.xpm
WE ./west.xpm
EA ./east.xpm
F 220,100,0
C 225,30,0

111111111111111111111111
110000000000000000000001
100000000000000000000001
100000000000000000000001
100000111110000101010001
100000100010000000000001
 00000100010000100010001
100000100010000000000001
100000110110000001010001
100000000000000000000001
100000000000000000000001
10000000000000000000111
1000000000000000000001
1100000000000011110001
  1110000000000000000001
111100000000000000000001
11111111100000000000011
100001000000000000001
10000010100000000000001
11010000100000000000000
110111111000000000000N01
1011111110000 00000001001
111111111111111111111111
