NO ./north.xpm
SO ./south.xpm
WE ./west.xpm
EA ./east.xpm
F 220,100,0
C 225,30,0

1111111111111111111111111
110000000000000000000001
100000000000000000000001
100000000000000000000001
100000111110000101010001
100000100010000000000001
100000100010000100010001
100000100010000000000001
100000110110000001010001
10000000000000000000000 
100000000000000000000001
10000000000000000000111
 000000000000000000001
1100000000000011110001
  1110000000000000000001
111100000000000000000001
111111111000000000000001
100001000000000000001
1010000010100000000000001
110100001000000000000001
110111111000000000000N01
11000000000001
111111111000000000001001
1111111111111111111111111
