NO ./north.xpm
SO ./south.xpm
WE ./west.xpm
EA ./east.xpm
F 220,100,0
C 225,30,0

111111111111111111111111
110000000000000000000001
100000000000000000000001
100000000000000000000001
100000111110000101010001
100000100010000000000001
100000110010000100010001
100000101010000000000001
100000110110000001010001
100000000000000000000001
100000000000000000000001
10000000000000000000111
1000000000000000000001
11000000000000111100011
11100000000000000000011
111100000000000000000001
10000100000000000000111
1000001111000000000000111
110100011000000000000001
110111111100000000000N01
1011111110000100000001001
1111111111111111 111111111
