NO ./textures/northwall.png
SO ./textures/southwall.png
WE ./textures/westwall.png
EA ./textures/eastwall.png
F 220,100,122
C 225,30,0

111111111111111111111111
11111111111111111111111
110000000000000000000001
100000000000000010000001
100000000000001100001111
10000011111011101010011
10000011110111111111111
10000011111111100010001
100000111111111000011111
100000100110110010100011
1000000000001111100000011
100000000000000000000001
1000000000000000N0001111
100000000000000000000111
110000000000000111000111
111000000000000000000111
1111000000000000000000001
100001000000000000001111
10000011110000000000011
11111111111111111111111
110111111111000000000001
111111111111111111111111
