NO ./textures/northwall.png
SO ./textures/southwall.png
WE ./textures/westwall.png
EA ./textures/eastwall.png

F 139,69,
C 128,128,1
 
111111111111111111111111
10001           110E0001
10001           11000001  
100011111111111111000001 
100011111111111111000001       
10001           11000001
10001           11000001
111111111111111111111111