NO ./textures/northwall.png
SO ./textures/southwall.png
WE ./textures/westwall.png
EA ./textures/eastwall.png
F 139,69,100
C 128,128,10

 
11111111111111111111111
0100E1           1100001
11111111111111111111111
11111111111111111111111
