NO ./north.xpm
SO ./south.xpm
WE ./west.xpm
EA ./east.xpm
F  220,100,0
C 225,30,0

111111111111111111111111
11111111111111111111111
110000000000000000000001
100000000000000000000001
100000000000000000000001
10000011111011101010011
1000001111111111111111                 
10000011111111100010001
10000011110000000000111
100000100110000001010001
100000000000000000000001
100000000000000000000001
100000000000000000001111
100000000000000000000111
11000000000000E111000111
111000000000000000000111
1111000000000000000000001
100001000000000000001111
10000011110000000000011
11111111111111111111111
110111111100000000000001
10111111100001111101111
11111111111111111111111
 
