NO ./textures/northwall.png
SO ./textures/southwall.png
WE ./textures/westwall.png
EA ./textures/eastwall.png
F 139,69,11
C 128,128,1

 
 111111111111111111111111
 100E1           1100001
 11111111111111111111111