NO ./textures/northwall.png
SO ./textures/southwall.png
EA ./textures/eastwall.png
WE ./textures/westwall.png
F 215,100,1
C 225,30,1

1111111111111111111111
111101111111110111111111
1000000000000000010000001
1000000000000000100000011111
1000000000000011000011111   
100000111110111010100111
100000111101111111111111  
100000111111111000100011 
1000001111111111000111111   
1000001001101100101000111   
100000000000111110000011
100000000000000000E000001 
1000000000000000000011111  
1000000000000000000001111 
1100000000000001110001111    
1110000000000000000001111    
1111000000000000000000001   
1000010000000000000011111   
1000001111000000000001111
11111111111111111111111111
111011111111000000000000001
11111111111111111111111111 
                             
