NO ./north.xpm
SO ./south.xpm
WE ./west.xpm
EA ./east.xpm
F 220,100,0
C 225,30,0

1111111111
100S000001
1000N00001
1000000001
1111111111
