NO ./north.xpm
SO ./south.xpm
WE ./west.xpm
EA ./east.xpm
F 220,100,0
C 225,30,0

1111111111
10000000 
1000000001
1N00000001
1111111111
