NO ./north.xpm
SO ./south.xpm
WE ./west.xpm
EA ./east.xpm
F  220,100,0
C 225,30,0


11111111111111111111111
110000000000000000000001
100000000000000000000001
100000000000000000000001
10000011011001101010011
1000000111101111111111
10000011110000000000111
100000100110000001010001
100000000000000000000001

100000000000000000001111
1000000000000000000000111
110000000000001111000111
111000000100000000000111
1111000000000E00000000001
100001000000000000001111
100000111100000000000111
111111111111111111111111
110111111100000000000001
1011111110000111110111111
111111111111111111111111
