NO ./north.xpm
SO ./south.xpm
WE ./west.xpm
EA ./east.xpm
F  220,100,0
C 225,30,0


111111111111111111111111
110000000000000000000001
100000000000000000000001
100000000000000000000001
100000110110011010100111
100000011110111111111111
100000111100000000001111
100000100110000001010001
100000000000000000000001
100000000000000000001111
100000000000000000000011
110000000000001111000111
111000000100000000000111
1111000000000N0000000001
100001000000000000001111
100000111100000000000111
111111111111111111111111
110111111100000000000001
101111111000011111011111
111111111111111111111111
